defeat - derrotar
cumbersome - incómodo/pesado/voluminoso
beware - tener cuidado
chase = pursue - perseguir
kidding - bromeando
I'm willing - estoy dispuesto a
engaged - comprometido	engagement - compromiso
vibes - vibraciones
brain - cerebro
motion - movimiento
insightful - perspicaz
awkward - torpe
regret - lamentar/arrepentirse
milestone - hito
dare - atrevimiento/atreverse
pin - alfiler
my mouth is watering - se me hace la boca agua
age (como verbo) - envejecer
it tastes good - sabe bien
tough - dificil/duro
envision - visualizar
willing - dispuesto a
borough - ciudad/barrio
boost - aumentar/elevar/subir
breach - vibracion/brecha/infraccion
early bird - anticipado
challenge - reto / desafio
agreement - acuerdo
approach - enfoque / aproximación
hug - abrazo/abrazar
outbreak - brote
wrap - envolver
pointless - inútil
blame - culpa
meat - carne
trunk - tronco
homesickness - nostalgia
shut up - callarse/cerrar
might - poder
sword - espada
insight - visión
tricky - dificil / astuto / espinoso
aim - tener como objetivo
down to earth - con los pies en la tierra
